C 225,30,0

F 220,100,250

NO ./assets/brick.xpm
SO ./assets/grass.xpm
WE ./assets/wood.xpm
EA ./assets/window.xpm

1111
11
1S1
1111