
NO ./assets/brick.xpm
SO ./assets/grass.xpm
WE ./assets/wood.xpm
EA ./assets/brick.xpm

F 220,100,0
C 225,30,0


11111111111111111111111111111
10000000001100000000000000001
10110000011100000001111111111
11111111110000000000000000011
10110000011100000000011111111
11111111100110000011101111001
11110111111111011100000010001
11110111111111011101010010001
11000000110101011100000010001
10000000000000001100000010001
10000000000000001100010000001
11000000110101000000000000001
11110111110101000000000000001
10000000001100000100000010001
10000000000000000000000001001
10000000111100010000N00001001
100000001  100110101110000001
10000000111110000001 10100001
11111111111111111111111111111
