NO ./assets/brick.xpm
SO ./assets/grass.xpm
WE ./assets/wood.xpm
EA ./assets/brick.xpm

F 130,230,40
C 225,30,0

        1111111111111111111111111
        1000000000110000000000001
        1011000001110000000000001
        1001000000000000000000001
111111111011000001110000000000001
100000000011000001110111111111111
11110111111111011100000010001
11110111111111011101010010001
11000000110101011100000010001111111111
100000000000000011000000100000000000011111
100000000000000011010100100000000000000001
110000011101010111110111100000000000000001111
110000011101010111110111100000000000000001111
110000011101010111110111100000000000000001111
110000011101010111110111100000000S000000010111
110000011101010111110111100000000000000010111
110000011101010111110111100000000000000001111
110000011101010111110111100000000000001000111
11110111 1110101 101111010001111111111111111
11111111 1111111 111111111111