C 225,30,0

F 220,100,250

NO ./assets/brick.xpm
SO ./assets/grass.xpm
WE ./assets/wood.xpm
EA ./assets/window.xpm

        1111111111111111111111111
        1000000000110000000000001
        1011000001110000S000000011
        10010000000000001000000001
1111111110110000011100000000000011
100000000011000001110111111111111
11110111111111011100000000101
11110111111111011100000000001
11000000110101011100000000111
10000000000000001100000000111
10000000000100001100000001111
1100000111010101111111111000111
11110111 1110101 101111010001
11111111 1111111 111111111111 
