NO ./assets/brick.xpm
SO ./assets/grass.xpm
WE ./assets/wood.xpm
EA ./assets/window.xpm

F 20,20,20
C 200,200,200

11111
10001
10S01
10101
11001
11001
11001
10001
10001
10001
10001
10001
11111
 
 
 
 
 
 
 
 
 
 
 
 
 
1